Android Studio	Android Studio
Studio	Studio
android	android
Android Lint	Android Lint
Lint	Lint
flavor	flavor
Built-in	内置的
in the same way	同样的
repositories	仓库
Build Types	Build Types
ProGuard	ProGuard
Library	Library
compatible	兼容的
Testing Android Library	Testing Android Library
as is the case 	如
as opposed to	而不是	as opposed to 和...相反;而不是
on a case by case basis	因情况而异
criteria	标准	标准，准则
AIDL	AIDL
Implicit declarations	隐含声明
potentially	可能	adv. 潜在地;可能地;<古>强有力地;权威地
in case	以防	免得;以防;也许
function properly	正常运行
as long as 	主要
in irrespective of	不论
in question	被谈论着的	考虑之中的，被谈论着的
Alternatively	或者	adv.
crunch	压缩
Exploded	加载的	分解
artifact	构件
race condition	资源竞争
Env var	环境变量
rev	版本
sort of	可以说	adv.
see above	见前
